つきのみと	月ノ美兎	名詞	
つきの	月ノ	名詞	
みと	美兎	名詞	
しずかりん	静凛	名詞	
しずか	静	名詞	
りん	凛	名詞	
ひぐちかえで	樋口楓	名詞	
ひぐち	樋口	名詞	
かえで	楓	名詞	
しぶやはじめ	渋谷ハジメ	名詞	
しぶや	渋谷	名詞	
はじめ	ハジメ	名詞	
すずやあき	鈴谷アキ	名詞	
ゆうきちひろ	勇気ちひろ	名詞	
けんもちとうや	剣持刀也	名詞	
けんもち	剣持	名詞	
とうや	刀也	名詞	
ぎるざれんさんせい	ギルザレンIII世	名詞	
ふしみがく	伏見ガク	名詞	
ふみのたまき	文野環	名詞	
うしみいちご	宇志海いちご	名詞	
うしみ	宇志海	名詞	
ゆうひりり	夕陽リリ	名詞	
もののべありす	物述有栖	名詞	
もののべ	物述	名詞	
すずかうたこ	鈴鹿詩子	名詞	
いえながむぎ	家長むぎ	名詞	
いえなが	家長	名詞	
もりなかかざき	森中花咲	名詞	
かざき	花咲	名詞	
あかばねようこ	赤羽葉子	名詞	
ようこ	葉子	名詞	
かなえ	叶	名詞	
ささきさく	笹木咲	名詞	
ささき	笹木	名詞	
さく	咲	名詞	
やみよのもるる	闇夜乃モルル	名詞	
やみよの	闇夜乃	名詞	
ほんまひまわり	本間ひまわり	名詞	
うみやしゃのかみ	海夜叉神	名詞	
なかおあずま	名伽尾アズマ	名詞	
なかお	名伽尾	名詞	
いずもかすみ	出雲霞	名詞	
とどろききょうこ	轟京子	名詞	
はなばたけちゃいか	花畑チャイカ	名詞	
やしろきずく	社築	名詞	
きずく	築	名詞	
はっさくゆず	八朔ゆず	名詞	
あづちもも	安土桃	名詞	
うづきこう	卯月コウ	名詞	
すずきまさる	鈴木勝	名詞	
りゅーしぇん	緑仙	名詞	
なるせなる	成瀬鳴	名詞	
なる	鳴	名詞	
はるさきえある	春崎エアル	名詞	
まかいのりりむ	魔界ノりりむ	名詞	
くずは	葛葉	名詞	
せつな	雪汝	名詞	
しいなゆいか	椎名唯華	名詞	
ゆいか	唯華	名詞	
たかみやりおん	鷹宮リオン	名詞	
あすかひな	飛鳥ひな	名詞	
なるとこがね	鳴門こがね	名詞	
かんだしょういち	神田笑一	名詞	
あめもりさよ	雨森小夜	名詞	
まいもとけいすけ	舞元啓介	名詞	
しょういち	笑一	名詞	
まいもと	舞元	名詞	
りんどうみこと	竜胆尊	名詞	
さくらりつき	桜凛月	名詞	
りつき	凛月	名詞	
まちたちま	町田ちま	名詞	
つきみしずく	月見しずく	名詞	
でびでびでびる	でびでび・でびる	名詞	
じょーりきいち	ジョー・力一	名詞	
りきいち	力一	名詞	
あちきた	遠北	名詞	
あちきたちなみ	遠北千南	名詞	
べるもんど	ベルモンド・バンデラス	名詞	
べるもんどばんでらす	ベルモンド・バンデラス	名詞	
ばんでらす	バンデラス	名詞	
やぐるま	矢車	名詞	
やぐるまりね	矢車りね	名詞	
ゆめおい	夢追	名詞	
ゆめおいかける	夢追翔	名詞	
かける	翔	名詞	
くどう	久遠	名詞	
くどうちとせ	久遠千歳	名詞	
わらべだ	童田	名詞	
わらべだめいじー	童田明治	名詞	
くろいしば	黒井しば	名詞	
くろい	黒井	名詞	
おのまちはるか	小野町春香	名詞	
ゆづき	夢月	名詞	
ゆづきろあ	夢月ロア	名詞	
ぐんどう	郡道	名詞	
ぐんどうみれい	郡道美玲	名詞	
せとみやこ	瀬戸美夜子	名詞	
みやこ	美夜子	名詞	
かたりべつむぐ	語部紡	名詞	
つむぐ	紡	名詞	
せんが	仙河	名詞	
どくずほんしゃ	ド葛本社	名詞	
いぬいとこ	戌亥とこ	名詞	
あんじゅかとりーな	アンジュ・カトリーナ	名詞	
りぜへるえすた	リゼ・ヘルエスタ	名詞	
おとぎばら	御伽原	名詞	
えら	江良	名詞	
おとぎばらえら	御伽原江良	名詞	
さえぐさあきな	三枝明那	名詞	
あきな	明那	名詞	
あいぞのまなみ	愛園愛美	名詞	
あいぞの	愛園	名詞	
ゆきしろ	雪城	名詞	
まひろ	眞尋	名詞	
ゆきしろまひろ	雪城眞尋	名詞	
えくすあるびお	エクス・アルビオ	名詞	
れゔぃえりふぁ	レヴィ・エリファ	名詞	ヴが混ざると登録してもうまく変換できないらしい
はやま	葉山	名詞	
まりん	舞鈴	名詞	
はやままりん	葉山舞鈴	名詞	
にゅい	ニュイ	名詞	
そしえーる	ソシエール	名詞	
えくす	エクス	名詞	
あるびお	アルビオ	名詞	
にゅいそしえーる	ニュイ・ソシエール	名詞	
はかせ	葉加瀬	名詞	
ふゆき	冬雪	名詞	
はかせふゆき	葉加瀬冬雪	名詞	
かがみ	加賀美	名詞	
はやと	ハヤト	名詞	
かがみはやと	加賀美ハヤト	名詞	
よるみ	夜見	名詞	
よるみれな	夜見れな	名詞	
まゆずみ	黛	名詞	
かい	灰	名詞	
まゆずみかい	黛灰	名詞	
あるす	アルス	名詞	
あるまる	アルマル	名詞	
あるすあるまる	アルス・アルマル	名詞	
あいば	相羽	名詞	
あいばういは	相羽ういは	名詞	
あまみやこころ	天宮こころ	名詞	
あまみや	天宮	名詞	
えりーこにふぁー	エリー・コニファー	名詞	
らとなぷてぃ	ラトナ・プティ	名詞	
はやせそう	早瀬走	名詞	
すこやかな	健屋花那	名詞	
すこや	健屋	名詞	
かな	花那	名詞	
しぇりんばーがんでぃ	シェリン・バーガンディ	名詞	
ふみ	フミ	名詞	
ほしかわさら	星川サラ	名詞	
やまがみかるた	山神カルタ	名詞	
やまがみ	山神	名詞	
えまおうがすと	えま★おうがすと	名詞	
るいすきゃみー	ルイス・キャミー	名詞	
まつかいまお	魔使マオ	名詞	
まつかい	魔使	名詞	
ふわみなと	不破湊	名詞	
しらゆきともえ	白雪巴	名詞	
ぐうぇるおすがーる	グウェル・オス・ガール	名詞	
ならか	奈羅花	名詞	
くるすなつめ	来栖夏芽	名詞	
ぷちふるーる	petit fleurs	名詞	
いぶらひむ	イブラヒム	名詞	
めりっさきんれんか	メリッサ・キンレンカ	名詞	
フレン	フレン・E・ルスタリオ	名詞	
かいだはる	甲斐田晴	名詞	
げんづきとうじろう	弦月藤士郎	名詞	
そらほしきらめ	空星きらめ	名詞	
そらほし	空星	名詞	
げんづき	弦月	名詞	
とうじろう	藤士郎	名詞	
ながおけい	長尾景	名詞	
あさひなあかね	朝日南アカネ	名詞	
あさひな	朝日南	名詞	
すおうさんご	周央サンゴ	名詞	
すおう	周央	名詞	
とうどうこはく	東堂コハク	名詞	
とうどう	東堂	名詞	
きたこうじひすい	北小路ヒスイ	名詞	
きたこうじ	北小路	名詞	
にしぞのちぐさ	西園チグサ	名詞	
にしぞの	西園	名詞	